12 15
...s.#.....t...
.xxx.#...###.xx
.x.x##..#####xx
....###..#####x
x..####........
..#####..###.#.
..##########.#.
..###########..
..#####..#####.
..#####..####..
..#...#...#....
.......xx......